caresses  ->  caress
ponies    ->  poni
ties      ->  ti
caress    ->  caress
cats      ->  cat
feed      ->  feed
agreed    ->  agree
plastered ->  plaster
bled      ->  bled
motoring  ->  motor
sing      ->  sing
conflated    ->  conflat
troubled     ->  troubl
sized        ->  siz
hopping      ->  hop
tanned       ->  tan
falling      ->  fall
hissing      ->  hiss
fizzed       ->  fizz
failing      ->  fail
filing       ->  fil
happy        ->  happi
sky          ->  sky
relational     ->  relat
conditional    ->  condition
rational       ->  rational
valenci        ->  valence
hesitanci      ->  hesitance
digitizer      ->  digit
conformabli    ->  conformable
radicalli      ->  radical
differentli    ->  different
vileli        - >  vile
analogousli    ->  analogous
vietnamization ->  vietnamize
predication    ->  predicate
operator       ->  operate
feudalism      ->  feudal
decisiveness   ->  decisive
hopefulness    ->  hopeful
callousness    ->  callous
formaliti      ->  formal
sensitiviti    ->  sensitive
sensibiliti    ->  sensible
triplicate     ->  triplic
formative      ->  form
formalize      ->  formal
electriciti    ->  electric
electrical     ->  electric
hopeful        ->  hope
goodness       ->  good
revival        ->  reviv
allowance      ->  allow
inference      ->  infer
airliner       ->  airlin
gyroscopic     ->  gyroscop
adjustable     ->  adjust
defensible     ->  defens
irritant       ->  irrit
replacement    ->  replac
adjustment     ->  adjust
dependent      ->  depend
adoption       ->  adopt
homologou      ->  homolog
communism      ->  commun
activate       ->  activ
angulariti     ->  angular
homologous     ->  homolog
effective      ->  effect
bowdlerize     ->  bowdler
probate        ->  probat
rate           ->  rate
cease          ->  ceas
controlling    ->  control
rolling        ->  roll